0000000000000000
00000s0000000mmm
mmmmmmm000000tsm
00000000000mmmmm
0s00000000000000
0mmiiimmmmmmmm00
0000000000000000
0000000000000mmm
000000000000m000
00000s00000m0000
p0000e0000m00000
mmmmmmmmmmmmmmmm
