0000000000000000
0000000000000mmm
mmmmmmm000000tsm
00000000000mmmmm
s000000000000000
mmiiiimmmmmmmm00
0000000000000000
0000000000000mmm
000000000000m000
00000s00000m0000
p0000e0000m00000
mmmmmmmmmmmmmmmm
