0000000e0000000p
000mtm0000000mmm
000000i000m0mmmm
00000000m00m000e
0000000m00000000
00000im000000mmm
0000000000000000
0memmm000000000m
00000000ii000000
0m000000000mtmm0
0000000000000000
mmmmmmmmmmmmmmmm
