000000000000000p
000mtm0000000mmm
000000i000m0mmmm
00000000m00m0000
0000000m00000000
00000im000000mmm
0000000000000000
0mmmmm000000000m
00000000ii000000
0m000000000mtmm0
0000000000000000
mmmmmmmmmmmmmmmm
