000s00000000000p
000mtm0000000mmm
000000i000mmmmmm
00000000m00m000e
0000000m0000000s
00000im000000mmm
0s0000000000i000
0memmm000000000m
0s000000ii000000
0m000000000mtmm0
000000000000000s
mmmmmmmmmmmmmmmm
