0000p00000000000
0000mttmmmmm0000
00000e0000000s00
000s00es0000mm00
00tt0000mmi00000
00000mm0s000e000
0000000mm000000s
00000000000mmttm
0000000000i00000
000000000i00i000
00e0ss00i00sssss
mmmmttmmmmmttmmm
eeeeeeeeeeeeeeee
