0000p00000000000
0000mttmmmmm0000
00000ee000000s00
000s000s0000mm00
00tt0000mmi0e000
00000mm0s0000000
0000000mm000000s
00000000000mmttm
0000000000i00000
000000000i00i000
00e0ss00i00sssss
mmmmttmmmmmttmmm
0000ee00000ee000
