000s000e0000000p
000mtm0000000mmm
000000i000m0mmmm
00000000m00m000e
0000000m0000000s
00000im000000mmm
0s00000000000000
0memmm000000000m
0s000000ii000000
0m000000000mtmm0
s000000000000000
mmmmmmmmmmmmmmmm
